{
  "name": "Castle Entry",
  "player_start": {
    "x": 2.5,
    "y": 2.5,
    "angle": 0.0
  },
  "enemies": [
    {"x": 5.5, "y": 6.5},
    {"x": 9.5, "y": 4.5},
    {"x": 3.5, "y": 8.5}
  ],
  "layout": [
    [1,1,1,1,1,1,1,1,1,1,1,1],
    [1,0,0,0,0,0,0,0,0,0,0,1],
    [1,0,2,2,2,2,2,0,2,2,0,1],
    [1,0,2,0,0,0,2,0,0,0,0,1],
    [1,0,2,0,0,0,2,0,2,2,0,1],
    [1,0,2,0,0,0,2,0,0,2,0,1],
    [1,0,2,2,0,2,2,2,0,2,0,1],
    [1,0,0,0,0,0,0,2,0,2,0,1],
    [1,0,2,2,2,0,0,2,0,2,0,1],
    [1,0,0,0,2,0,0,0,0,2,0,1],
    [1,0,0,0,0,0,0,0,0,0,0,1],
    [1,1,1,1,1,1,1,1,1,1,1,1]
  ]
}
